######################
#S      ########## ###
#### ##    ####      #
#### #####R     #### #
####U  ###### ######E#
######################