######################
#P      ########## ###
#### ##S  K####      #
#### #####      ####P#
####   ###### ######E#
######################