#####################
#S                  #
### ############### #
#   #             # #
# # # # ######### # #
# # # # #       # # #
# # # # # ##### # # #
# # # # # #   # # # #
# # # # # # # # # # #
# # # # # # # # # # #
# # # # # # # # # # #
# # # # # # # # # #E#
#####################